.********.
**..**..**
*........*
.********.
*...**...*
.**....**.
*...**...*
.**....**.
**..**..**
.********.